
       WE              ./images/colorstone.xpm





F        74,41,41





      NO                       ./images/wood.xpm
      



SO ./images/greystone.xpm                 



C 231,236,249

      EA          ./images/mossy.xpm              



1111111111
1000000001
1000000001
1000010001
1000000001
1000000001
1000000001
1000000001
1S00000001
1111111111
